NO ./textures/Mossy_Cobblestone_DIFF2.xpm
SO ./textures/Planks_01_DISP.xpm
WE ./textures/Potato_normal.xpm
EA ./textures/Wooden_Shingles_SPEC.xpm

F 31,30,21
C 141,181,191

1111111
1000001
1001111
1E01
1111
