

    1111
11110001
10010011
100111
1E011
1111 11
