

    1111                11111
11110001                00001
10010011                11111
100111
1E011
1111 11
